0000000011
1110011101
1000011001
0010100000
0011101110
0001111000
0010101000
1111000110
1101001111
1001011000
