1111100010
0000101011
0011010001
0100011011
1001000100
0011011000
1100010110
0011101010
1010111001
1000010100
