000001001010
001101111111
110000110000
010111000110
011111000011
110111011011
100000111010
100000100101
100000000101
100101111000
011100110100
001000001010
