110101000011
000110110010
111011010011
101000001010
111000010110
001001000001
110101001010
100010010010
100001100100
110011000101
011110101011
100000100111
