1110101111011
1110111011010
0111110110111
1111010110110
1011011111111
0111110111111
1111110111111
1011111111110
1111100111111
0111111111111
1101101111111
1101111111101
0010110011111
