1110101011110
1111111101111
1111111111111
0011100110101
1101101111111
1111001111111
0110111111111
1111111111111
1111101111010
1111111111000
1001100011111
1111111001110
1101101111111
