00000001111001001000
00000100011111000111
00010001000111001101
10110000101010100000
00000101010000100111
11010100001010110010
10000000001100000001
01010000000110010011
00100111000101000000
11010011011010010111
10011001111000101101
00010100010000001110
10101010000000011001
00010000001001000100
00001011000000110100
10010100101000011000
00000000110001001101
00100100000000010111
10100000100001011011
00100000001000001001
