11000110011010001000
01100010100001010000
10000010100001000000
11100010101001101000
11110001110000000000
00110001011010110100
10000000110000000101
10001101000010001000
00000000010000110100
10010001001110001010
11101000001101000000
00000000001010000011
01000110011101101001
00001001101100000011
11011011001011010000
10000001000111101111
00100010111100000010
00010010101001110100
10000010000010010000
00110100110100000010
