10000110100110000111
10100000100100000100
11101000010000000100
00000011100100100100
10101010100100001111
00100010001010100100
00000000100010010010
11101111001001010000
00100111110100011000
00101100000101010001
00100100000000000100
00000110010001101000
00000001101100011100
00000010011100000010
00000010101011010010
01011101010001101011
01100010110000010100
00100101110010011000
10110101000001011000
00010000000011011010
