10001001000001010000
10010001001001010011
00001010001000100001
10100000000110000101
00100100000101000101
00010100000010000100
00100100001000011000
10100100000110110000
10001100011100000001
00000000000100100111
10110100000100010110
11001010000101001100
11000100000100100001
11110000101001011100
11111011011111100100
11011100010001000011
10010000000001010000
00110001111100101000
01100000100101101110
00001000000110001010
