00100000000001010010
00010100010101000011
00100000101101000101
10100000001001001110
00100100010100111000
01110010100101000100
01100000100010001111
00100001000010000001
01100001010000100100
10100101101001000001
00001011000100110001
01011101100000000110
10010100001100001001
10100010000100000111
10010101010110001000
00000011010010000000
11011000001010100010
00000011100000111101
01010000110110100001
00101000010011110110
