01011000100101010010
00000100000111010001
01001011100001011011
01100000000000000010
00110010110000001000
01000110010010000100
00110000011000011011
10101001010000111000
11101000110011000110
11101000101111101011
11100000010001110101
01000100000010010000
00010011101101101100
01110001100000011000
00100000000000000000
00101100100001001001
00000110100000000111
01000110000001110000
00110001000000000110
01001000100010110010
