11110000000010010000
01101100100001100000
10101011000000011010
01010101100000101110
00000111101110000001
00100011100001100100
00010000100001011000
00000110000000010110
01001001001111100110
01000010010001100100
00100110110101000000
00010100000000011110
10000000110011000110
00010100000010110110
01011010100001000001
00000011110100000110
00111000101111011001
10101101001100010000
00000010001001000000
01010000001000001011
