11000011011000101110
00001101000001001010
00110000000100001000
00000100010110000100
00111100011110000000
00101010101001000011
10110100111001010100
01111010000000100010
00100100001000110001
01001000000001001000
00101010101000011001
10000000000000101101
01000110100101000010
00010101001101000011
00110001001000100001
00110100100101000000
00100000010011001011
00011010001011010100
11101100110100000001
10100100010100001110
