10001000110000110000
11101011111000010010
00000001001001010111
00001001011000101001
00011001011010100000
11111010100001101000
00000101001100110101
00100100100110111011
11010110000000010011
00111010100001000001
00000000100010000100
00110001001000001000
00000011000110001111
01000001000011101100
01001011001011000000
00100000010000000111
00100000001011110000
00100011000001010010
00101111000000000011
00100010100000001010
